5 5 5 5 5 5 5 5 5 5 5 5 5 6 5 5 5 5 5 5 5 5 5 5 5 0 0 0 0 0 0 4 1 0 0 0 0 0 0 0 0 0 0 0 0 0 0 0 0 0 
5 5 5 5 5 5 5 5 5 5 5 5 5 6 5 5 5 5 5 5 5 5 5 5 5 0 0 0 0 0 0 4 1 0 0 0 0 0 0 0 0 0 0 0 0 0 0 0 0 0 
5 5 5 5 5 5 5 5 5 5 5 5 5 6 5 5 5 5 5 5 5 5 5 5 5 0 0 0 0 0 0 4 1 0 0 0 0 0 0 0 0 0 0 0 0 0 0 0 0 0 
5 5 5 5 5 5 5 5 5 5 5 5 5 6 5 5 5 5 5 5 5 5 5 5 0 0 0 0 0 0 0 4 1 0 0 0 0 0 0 0 0 0 0 0 0 0 0 0 0 0 
5 5 5 5 5 5 5 5 5 5 5 5 5 6 5 5 5 5 5 5 5 5 5 5 0 0 0 0 0 0 0 4 1 0 0 0 0 0 0 0 0 0 0 0 0 0 0 0 0 0 
5 5 5 5 5 5 5 5 5 5 6 6 6 6 5 5 5 5 5 5 5 5 5 0 0 0 0 0 0 0 0 4 1 0 0 0 0 0 0 0 0 0 0 0 0 0 0 0 0 0 
5 5 5 5 5 6 6 6 6 6 6 5 5 5 5 5 5 5 5 5 5 5 0 0 0 0 3 0 0 0 0 4 1 0 0 0 0 0 0 0 0 0 0 0 0 0 0 0 0 0 
5 5 5 5 6 6 5 5 5 5 5 5 5 5 5 5 5 5 5 5 0 0 0 0 0 0 0 0 0 0 0 4 1 1 1 1 1 1 1 1 1 1 1 1 1 1 1 1 1 1 
5 5 5 5 6 5 5 5 5 5 5 5 5 5 5 5 0 0 0 0 0 0 0 0 0 0 0 0 0 0 0 4 4 4 4 4 4 4 4 4 4 4 4 4 4 4 4 4 4 4 
5 5 5 5 6 5 5 5 5 5 5 5 0 0 0 0 0 0 0 0 0 0 0 0 0 0 0 0 0 0 0 0 0 0 0 0 0 0 0 0 0 0 0 0 0 0 0 0 0 0 
5 5 5 5 6 5 5 5 5 5 5 0 0 0 0 0 0 0 0 0 0 0 0 0 3 0 0 0 0 0 0 0 0 0 0 0 0 0 5 5 5 5 0 0 0 0 0 0 0 0 
5 5 5 5 6 5 5 5 5 0 0 0 0 0 0 0 0 0 3 0 0 0 0 0 0 0 0 0 0 0 0 0 0 0 5 5 5 5 5 2 2 5 5 5 0 0 0 0 0 0 
5 5 5 5 6 5 5 5 0 0 0 0 0 0 0 0 0 0 0 0 0 0 0 0 0 0 0 0 0 0 0 0 0 5 5 2 2 2 2 2 2 2 2 5 5 0 0 0 0 0 
5 5 5 5 6 6 5 0 0 0 0 0 0 0 0 0 0 0 0 0 0 0 0 0 0 0 0 0 0 0 0 0 5 5 2 2 2 2 2 2 2 2 2 2 5 0 0 0 0 0 
5 5 5 5 5 6 6 6 6 6 6 6 6 6 6 6 6 6 6 6 6 6 0 0 0 0 0 0 0 0 5 5 5 2 2 2 2 2 2 2 2 2 2 2 5 5 0 0 0 0 
5 5 5 5 5 5 5 0 0 0 0 0 0 0 0 0 6 0 0 0 0 6 0 0 0 0 0 0 0 0 5 2 2 2 2 2 2 2 2 2 2 2 2 2 2 5 5 0 0 0 
5 5 5 5 5 5 5 0 0 0 0 3 0 0 0 0 6 0 0 0 0 6 0 0 0 0 0 0 0 0 2 2 2 2 2 2 2 2 2 2 2 2 2 2 2 2 5 0 0 0 
5 5 5 5 5 5 0 0 0 0 0 0 0 0 0 0 6 0 0 0 0 6 0 0 0 6 6 6 6 6 2 2 2 2 2 2 2 2 2 2 2 2 2 2 2 2 5 5 0 0 
5 5 5 5 5 0 0 0 0 0 0 0 0 0 0 0 6 0 0 0 0 6 0 0 0 6 0 0 0 5 2 2 2 2 2 2 2 2 2 2 2 2 2 2 2 2 2 5 0 0 
5 5 5 5 0 0 0 0 0 0 0 0 0 0 0 0 6 0 0 0 0 6 6 6 6 6 0 0 0 5 5 2 2 2 2 2 2 2 2 2 2 2 2 2 2 2 2 5 0 0 
5 5 5 5 0 0 0 0 0 0 0 0 0 0 0 0 6 0 0 0 0 0 0 0 0 0 0 0 0 0 5 5 2 2 2 2 2 2 2 2 2 2 2 2 2 2 2 5 0 0 
5 5 5 5 5 0 0 0 0 0 0 0 0 0 0 0 6 0 0 0 0 0 0 0 0 0 0 0 0 0 0 5 5 2 2 2 2 2 2 2 2 2 2 2 2 2 2 5 0 0 
5 5 5 5 5 0 0 0 0 0 0 0 0 0 0 0 6 0 0 0 0 0 0 0 0 0 0 0 0 0 0 0 5 2 2 2 2 2 2 2 2 2 2 2 2 2 5 5 0 0 
5 5 5 5 0 0 0 0 0 0 0 0 0 0 0 0 6 0 0 0 0 0 0 0 0 0 0 0 0 0 0 0 5 2 2 2 2 2 2 2 2 2 2 2 2 0 0 0 0 0 
5 5 5 5 0 0 0 0 0 0 0 0 0 0 0 0 6 0 0 0 0 0 3 0 0 0 0 0 0 0 0 0 5 5 2 2 2 2 2 2 2 2 2 2 2 0 0 0 0 0 
5 5 5 0 0 0 0 0 0 0 0 0 0 0 0 0 6 0 0 0 0 0 0 0 0 0 0 0 0 3 0 0 0 5 5 5 5 2 2 2 2 2 2 2 0 0 0 0 0 0 
5 0 0 0 0 0 0 0 0 0 0 0 0 0 0 0 6 0 0 0 0 0 0 0 0 0 0 0 0 0 0 0 0 0 0 0 5 5 5 5 5 5 5 5 0 0 0 0 0 0 
0 0 0 0 3 0 0 0 0 0 0 0 0 0 0 0 6 0 0 0 0 0 0 0 0 0 0 0 0 0 0 0 0 0 0 0 0 0 0 0 0 0 0 0 0 0 0 0 0 0 
0 0 0 0 0 0 0 0 0 0 0 0 0 0 0 0 6 0 0 0 0 0 0 0 0 0 0 0 0 0 0 0 0 0 0 0 0 0 0 0 0 0 0 0 0 0 0 0 0 0 
0 0 0 0 0 0 0 0 0 0 0 0 0 0 0 0 6 0 0 0 0 0 0 0 0 0 0 0 0 0 0 0 0 0 0 0 0 0 0 0 0 0 0 0 0 0 0 0 0 0 
0 0 0 0 0 0 0 0 0 0 0 0 0 0 0 0 6 0 0 0 0 0 0 0 0 0 0 0 0 0 0 0 0 4 4 4 4 4 4 4 0 0 0 0 0 0 0 0 0 0 
0 0 0 0 0 0 0 0 0 0 3 0 0 0 0 0 6 6 6 6 6 6 0 0 4 4 4 4 4 4 4 4 4 4 3 3 3 3 3 4 4 0 0 0 0 0 0 0 0 0 
4 4 4 4 0 0 0 0 0 0 0 0 0 0 0 0 0 0 0 0 0 6 0 0 3 3 3 3 3 3 3 3 3 3 3 3 3 3 3 3 4 4 0 0 0 0 0 0 0 0 
1 1 1 4 0 0 0 0 0 0 0 0 0 0 0 0 0 0 0 0 0 6 0 3 3 3 3 3 3 3 3 3 3 3 3 3 3 3 3 3 3 4 0 0 0 0 0 0 0 0 
0 0 1 4 4 0 0 0 0 0 0 0 0 0 0 0 0 0 0 0 0 6 6 6 6 6 6 3 3 3 3 3 3 3 3 3 3 3 3 3 3 4 0 0 0 0 0 0 0 0 
0 0 1 1 4 0 0 0 0 0 0 0 0 0 4 0 0 0 0 0 0 0 4 3 3 3 6 6 3 3 3 6 6 6 6 6 3 3 3 3 3 4 0 0 0 0 0 0 0 0 
0 0 0 1 4 0 0 3 0 0 0 0 0 0 0 0 0 0 0 3 0 0 4 3 3 3 3 6 3 3 3 6 3 3 3 6 6 6 3 3 3 4 4 0 0 0 0 0 0 0 
0 0 0 1 4 0 0 0 0 0 0 0 0 0 0 0 0 0 0 0 0 0 4 3 3 3 3 6 6 6 6 6 3 3 3 3 3 3 3 3 3 3 4 0 0 0 0 0 0 0 
0 0 0 1 4 0 0 0 0 0 0 0 0 0 0 0 0 0 0 0 0 0 4 3 3 3 3 3 3 3 3 6 3 3 3 3 3 3 3 3 3 3 4 0 0 0 0 0 0 0 
0 0 1 1 4 0 0 0 0 0 0 0 0 0 0 0 3 0 0 0 0 4 4 3 3 3 3 3 3 3 3 6 6 6 3 3 3 3 3 3 3 4 4 0 0 0 0 0 0 0 
0 0 1 4 4 0 5 5 5 5 5 0 0 0 0 0 0 0 0 0 0 4 3 3 3 3 3 3 3 3 6 6 3 6 6 3 3 3 3 3 3 4 0 0 5 5 5 5 0 0 
0 0 1 0 0 0 2 2 2 2 5 0 0 0 0 0 0 0 0 0 0 4 3 3 3 3 3 3 6 6 6 3 3 3 6 3 3 3 3 3 3 4 0 0 5 5 5 5 0 0 
0 0 1 0 0 5 2 2 2 2 5 5 0 0 0 0 0 0 0 0 4 4 3 3 3 3 3 5 6 3 3 3 3 3 6 6 6 3 3 3 3 4 0 0 5 5 5 5 0 0 
0 0 1 0 0 5 2 2 2 2 2 5 0 4 4 4 4 4 0 0 4 3 3 3 3 3 3 5 5 3 3 3 3 3 3 3 6 6 3 3 3 4 0 0 5 5 5 5 0 0 
0 0 1 0 0 5 2 2 2 2 2 0 4 4 1 1 1 4 0 0 4 3 3 3 3 3 3 3 3 3 3 3 3 3 3 3 3 6 6 6 6 6 6 6 5 5 5 5 0 0 
0 0 1 0 0 5 5 5 5 5 0 0 4 1 1 0 1 1 4 0 4 3 3 3 3 3 3 3 3 3 3 3 3 3 3 3 3 3 3 3 3 4 0 0 5 5 5 5 0 0 
0 0 1 0 0 0 0 0 0 0 0 0 4 1 0 0 0 1 4 0 4 4 4 3 3 3 3 3 3 3 3 3 3 3 3 3 3 3 3 3 4 4 0 0 5 5 5 5 0 0 
0 0 1 1 1 1 1 1 1 1 1 1 1 1 0 0 0 0 1 0 0 0 4 3 3 3 3 3 3 3 3 3 4 4 4 4 4 4 4 4 4 0 0 0 0 0 0 0 0 0 
0 0 0 0 0 0 0 0 0 0 0 0 0 0 0 0 0 0 1 1 0 0 4 4 3 3 3 3 3 3 3 3 4 0 0 0 0 0 0 0 0 0 0 0 0 0 0 0 0 0 
0 0 0 0 0 0 0 0 0 0 0 0 0 0 0 0 0 0 0 1 0 0 0 4 4 4 4 4 4 4 4 4 4 0 0 0 0 0 0 0 0 0 0 0 0 0 0 0 0 0 