0 0 0 0 0 0 0 0 0 0 0 0 0 0 0 0 0 0 0 0 0 0 0 0 0 0 0 0 1 0 0 0 0 0 0 0 0 0 0 0 0 0 0 0 0 0 0 0 0 0 
0 0 0 0 0 0 3 0 0 0 0 0 3 0 0 0 0 0 0 0 0 0 0 0 0 0 0 0 1 4 4 4 4 4 0 0 0 0 0 0 0 0 0 0 0 0 0 0 0 0 
0 0 0 0 0 0 0 0 0 0 0 0 0 0 0 0 0 0 6 6 6 6 6 6 6 0 0 0 0 1 1 1 1 1 0 0 4 4 4 4 0 0 0 0 0 0 0 0 0 0 
0 0 3 0 0 0 0 0 0 6 6 6 6 6 6 6 6 6 6 0 0 0 0 0 6 6 0 0 0 0 0 0 0 0 1 1 1 1 1 1 0 0 4 4 0 0 0 0 0 0 
0 0 0 0 0 0 0 0 6 6 0 0 0 0 0 0 0 0 0 0 0 0 0 0 0 6 6 0 0 0 0 0 0 0 0 0 0 0 0 1 1 1 1 4 0 4 0 0 0 0 
0 0 0 3 0 0 0 6 6 0 0 0 0 0 0 0 4 0 0 0 0 0 0 0 6 6 6 6 6 6 6 6 6 6 0 0 0 0 0 0 0 0 0 1 1 1 4 0 0 0 
0 0 0 0 0 0 6 6 0 0 0 0 0 0 0 0 0 0 0 0 0 0 0 6 0 0 0 0 0 0 0 0 0 0 6 6 6 6 6 6 6 0 0 0 0 1 4 0 0 0 
0 0 0 0 0 6 6 0 0 4 4 0 0 0 0 0 0 0 0 0 0 3 0 6 6 0 0 5 5 0 0 0 0 0 0 0 0 0 0 0 6 6 6 0 0 1 4 4 4 0 
0 0 0 0 0 6 0 4 0 3 0 0 0 3 0 3 0 0 0 0 0 0 0 6 0 6 5 2 2 2 2 0 0 0 0 0 0 0 0 0 0 0 0 6 6 0 1 1 4 0 
0 3 0 0 0 6 0 0 3 0 3 3 4 0 0 0 0 0 0 0 0 0 6 3 0 6 5 2 2 2 2 4 0 0 0 0 3 0 0 0 3 0 0 0 6 6 0 1 1 1 
0 0 0 0 6 6 0 3 3 3 3 3 3 0 0 0 3 0 0 3 0 6 6 0 0 0 5 2 2 2 2 4 0 0 0 0 0 0 0 0 0 0 0 0 0 6 0 0 0 0 
0 0 0 6 6 0 0 3 3 3 3 0 0 4 0 4 0 0 0 0 0 6 0 0 0 2 2 2 2 2 2 0 0 0 0 0 0 0 0 0 0 0 0 0 6 0 0 0 0 0 
0 3 0 6 0 0 0 3 3 3 3 3 0 3 0 0 0 0 6 6 6 0 0 0 4 2 2 2 2 2 4 0 0 0 0 0 0 0 6 6 6 6 6 6 0 5 5 5 0 0 
0 3 0 6 0 4 3 0 3 3 3 3 3 4 0 4 0 0 6 0 0 0 0 0 0 2 2 5 5 4 0 0 0 0 6 6 6 6 0 0 0 0 0 3 5 2 2 2 2 0 
0 0 0 6 0 0 3 4 0 3 3 3 0 0 4 0 6 6 6 6 6 6 0 0 0 5 5 5 6 6 0 0 6 6 6 0 0 0 0 0 0 0 3 2 2 2 2 2 2 0 
0 0 0 6 4 0 0 0 3 3 0 0 3 0 0 6 6 0 0 0 0 0 6 0 0 0 0 0 3 0 0 0 6 0 0 0 0 0 0 0 0 0 5 2 2 2 2 2 2 0 
0 3 0 6 0 0 4 0 0 0 0 4 0 0 0 6 0 0 0 4 0 0 6 6 0 0 0 0 3 3 0 0 6 6 0 0 0 0 0 0 0 0 5 2 2 2 2 2 5 0 
0 0 0 6 0 0 0 0 0 6 6 6 6 6 6 0 0 0 0 0 0 0 0 6 0 0 0 0 0 6 6 0 0 4 6 6 6 0 0 0 0 0 0 2 2 2 2 2 5 0 
0 0 0 6 6 0 0 6 6 6 0 0 0 0 0 0 0 0 0 0 0 0 0 6 0 0 0 0 0 6 6 0 0 6 6 4 6 6 6 6 6 0 0 5 2 2 2 2 5 0 
0 0 0 0 6 6 6 6 0 0 0 0 0 0 0 0 0 4 0 0 0 0 0 6 0 0 0 6 6 6 6 0 0 6 0 0 4 4 0 0 0 6 0 0 5 5 0 3 6 0 
0 0 0 0 0 0 0 0 0 0 0 0 0 0 0 3 0 0 0 0 0 6 6 6 0 0 0 6 5 5 6 0 6 6 0 0 0 0 0 0 0 0 6 6 0 0 0 0 6 0 
0 0 0 0 0 0 0 0 4 4 0 0 0 0 0 0 0 0 6 6 6 0 0 0 0 0 0 5 5 5 5 0 6 0 0 0 0 0 0 0 0 0 0 6 6 0 0 0 6 0 
0 0 0 4 0 0 0 0 0 0 0 0 6 6 0 0 0 6 6 0 0 0 0 0 0 0 5 5 5 5 5 0 6 0 0 3 0 0 0 0 0 0 0 0 6 0 0 0 6 6 
0 0 4 0 0 0 0 0 0 6 6 6 0 6 6 6 3 0 0 0 0 0 0 0 0 0 5 5 5 5 5 6 6 0 0 0 0 0 0 3 0 0 0 0 6 0 0 0 0 6 
6 0 0 0 0 0 0 0 6 6 0 0 0 0 0 0 0 0 0 0 3 0 0 0 0 0 5 5 5 0 6 6 0 0 0 4 0 0 0 0 0 0 0 0 6 0 0 0 0 6 
0 6 6 6 0 0 0 6 6 6 0 0 3 0 0 0 0 3 0 0 0 0 0 0 0 5 5 5 0 6 6 0 0 0 0 0 0 0 0 0 0 0 0 0 6 0 0 0 0 6 
0 0 0 6 0 0 0 6 0 6 6 6 6 6 6 0 0 0 6 6 6 6 6 0 0 0 0 0 4 6 0 0 0 4 0 0 0 4 0 4 0 0 0 6 6 0 0 0 0 6 
0 0 0 6 6 0 6 6 0 0 0 0 0 0 6 6 6 6 6 0 0 0 6 6 6 6 6 6 6 0 0 3 0 0 0 0 0 6 6 6 6 6 6 6 0 0 3 0 6 6 
0 0 0 0 6 6 0 0 0 0 0 4 4 4 4 0 3 0 3 0 0 5 0 0 0 0 0 0 0 0 0 0 0 0 0 0 6 6 0 0 0 0 0 6 0 0 0 0 6 0 
0 0 0 0 6 0 0 0 0 0 0 4 5 5 5 5 5 5 5 5 5 2 5 4 0 4 0 0 0 3 0 0 0 0 0 6 6 0 0 0 5 4 0 6 6 0 0 6 6 0 
0 3 0 0 6 6 0 0 0 0 4 5 2 2 2 2 2 2 2 2 2 2 2 5 4 0 0 0 0 0 0 0 0 0 0 6 4 0 0 2 2 5 0 0 0 6 6 6 0 0 
0 0 0 0 0 6 0 0 0 0 5 5 2 2 2 2 2 2 2 2 2 2 2 2 5 4 0 4 0 0 0 4 0 0 0 6 4 0 2 2 2 2 4 0 0 0 0 0 0 0 
0 0 0 0 0 6 0 0 0 5 2 2 2 2 2 2 2 2 2 2 2 2 2 2 5 4 0 0 0 0 0 4 0 0 0 6 0 0 2 2 2 2 5 0 0 0 0 0 0 0 
0 0 0 0 0 6 6 0 0 5 2 2 2 2 2 2 2 2 2 2 2 2 2 2 5 4 0 0 0 0 0 0 0 0 6 6 4 0 4 5 5 2 5 0 0 0 0 0 0 0 
0 0 3 0 0 0 6 0 5 5 2 2 2 2 2 2 2 2 2 2 2 2 2 2 2 5 0 0 0 0 0 0 0 6 0 6 0 0 0 0 0 5 0 0 0 1 1 1 1 1 
0 0 0 0 0 0 6 0 5 2 2 2 2 2 2 2 2 2 2 2 2 2 2 2 2 5 0 0 0 0 4 6 6 0 0 0 6 6 0 0 0 0 4 1 1 1 0 0 0 0 
0 0 0 0 0 0 6 0 5 2 2 2 2 2 2 2 2 2 2 2 2 2 2 2 2 0 0 0 0 4 6 6 0 0 0 0 0 6 6 6 4 4 4 1 0 0 0 0 0 0 
0 0 0 0 0 0 5 5 2 2 2 2 2 2 2 2 2 2 2 2 2 2 2 2 2 0 3 0 0 0 4 6 6 0 0 0 0 0 0 6 1 1 1 0 0 0 0 4 0 0 
0 0 0 0 0 0 5 2 2 2 2 2 2 2 2 2 2 2 2 2 2 2 2 2 2 0 0 0 0 0 0 4 4 6 0 0 0 0 0 6 4 4 4 0 0 0 0 0 0 0 
3 0 0 0 0 5 2 2 2 2 2 2 2 2 2 2 2 2 2 2 2 2 2 2 2 0 0 0 0 0 0 0 0 4 6 0 0 0 1 4 0 4 0 0 0 0 0 0 0 0 
0 0 0 0 0 5 2 2 2 2 2 2 2 2 2 2 2 2 2 2 2 2 2 2 2 5 0 0 0 0 0 0 0 4 6 0 0 1 4 0 0 0 0 0 0 4 0 0 0 0 
0 0 0 3 3 5 2 2 2 2 2 2 2 2 2 2 2 2 2 2 2 2 2 2 5 0 0 0 0 0 0 0 0 0 6 0 0 1 0 0 0 0 0 0 0 0 0 0 4 0 
0 0 0 0 0 0 2 2 2 2 2 2 2 2 2 2 2 2 2 2 2 2 2 5 5 0 0 0 0 0 0 0 6 6 6 0 0 1 0 0 0 0 4 0 0 0 0 0 0 0 
0 0 0 0 0 6 2 2 2 2 2 2 2 2 2 2 2 2 2 2 2 0 0 0 0 3 0 0 0 6 6 6 6 0 0 0 1 0 0 0 0 0 0 0 0 0 4 0 0 0 
0 0 0 0 6 0 0 3 5 5 2 2 2 2 2 2 2 5 5 5 4 0 0 0 0 0 0 0 6 6 0 0 0 0 0 0 1 0 0 0 0 0 0 4 0 0 0 0 0 0 
0 6 6 6 0 0 0 0 4 5 5 5 5 5 5 5 5 4 4 0 0 0 0 0 0 0 0 0 6 0 0 0 0 0 0 1 1 0 0 0 0 0 0 0 0 0 0 0 0 0 
6 0 0 6 6 0 0 0 0 4 0 0 4 0 0 3 0 0 0 3 0 0 0 0 0 0 0 0 6 0 0 0 0 0 1 1 0 0 0 4 0 0 0 0 0 0 0 0 0 0 
6 0 0 0 6 6 6 0 0 0 0 0 0 0 0 0 0 0 0 0 0 0 0 0 0 0 6 6 6 0 0 0 0 0 1 0 0 0 0 0 0 0 0 0 0 0 0 0 0 0 
6 0 0 0 0 0 0 6 6 6 6 6 6 6 6 6 6 6 6 6 6 6 6 6 6 6 6 0 0 0 0 0 0 0 1 0 0 0 0 0 0 0 0 4 0 0 0 4 0 0 
0 0 0 0 0 0 0 0 0 0 0 0 0 0 0 0 0 0 0 0 0 0 0 0 0 0 0 0 0 0 0 0 0 0 1 0 0 0 0 0 0 0 0 0 0 0 0 0 0 0 