1 0 1 1 1 0 1 1 1 1 1 1 1 1 1 1 
2 2 0 0 0 0 0 0 0 0 0 4 0 5 5 0 
1 2 2 2 0 0 0 0 3 3 0 0 0 0 5 0 
0 0 0 2 2 0 0 0 2 2 0 0 3 6 6 0 
0 0 0 2 2 2 0 2 2 2 2 0 6 6 6 1 
1 0 0 0 0 2 2 2 2 2 2 2 8 6 6 1 
1 0 0 0 0 0 2 2 2 2 2 2 2 8 6 1 
1 0 0 0 0 0 4 2 2 2 2 2 2 0 8 1 
1 0 4 4 0 0 4 4 2 2 2 2 5 0 0 1 
1 7 7 7 0 0 0 0 5 5 5 0 0 0 0 1 
1 6 6 7 3 0 0 0 0 0 0 0 0 0 0 1 
1 1 0 1 1 1 1 1 1 1 1 1 1 0 0 1 